AFK		Away from Keyboard
FYI 	For Your Information 
BRB		Be right Back 
LOL		Loud lauthing
ASAP	As soon as possible
GN8		gute Nacht
B2B		Business to Business
B2C		Business to Customer
YOLO	You only live once
*Korrektur	Korrekturkennzeichnung
143		I love you
2F4U	Too Fast For You
2L8		Too Late
4U		For you
4YEO/FYEO	For Your Eyes Only
AAMOF	As A Matter Of Fact
Acc		Account
ACK		Acknowledgment
AFAIC	As Far As Im Concerned
AFAICT	As Far As I can tell
AFAIK	As Far As I Know
AFAIR	As Far As I Remember
AFK		Away from Keyboard
AGF		Assume good faith
AISI	As I see it
AIUI	As I understand it
AKA		Also known as
ANSCD	And now something completely different …
ASAP	As soon as possible
ASL 	(auch A/S/L)	Age Sex Location
ATM		At The Moment
B2K/BTK	Back To Keyboard
B2T/BTT	Back To Topic
BB		Bye, Bye/Bis bald
BBIAB	Be Back In A Bit
BBL		Be Back Later
BBS		Be Back Soon
BD		Bis dann
BF		Beste Freunde
BG		breitgrins
BM		Bis morgen
BN		Bis nachher
BOFH	Bastard Operator From Hell
BR		Best regards
BRB		Be Right Back
BTAIM	Be that as it may
BTDT	Been there, done that
BTW		By The Way
C&P/CP	Copy and Paste
C6/CS	Cybersex
CU		See You
CUL8R	See You later
CYA		See Ya/See You Again/See You All
Dafuq	What the fuck
DAU		Dümmster anzunehmender User
DL oder D/L	Download
DFTT	Dont Feed The Troll”
DND		Do Not Disturb
DUW		Duck und weg
EOBD	End Of Business Day
EOD		End Of Discussion
EOM		End of message
EOT		End Of Thread/End of Text/End of Transmission
F2F		Face to Face
FACK/Full Ack	Full Acknowledge
FAQ		Frequently Asked Questions
FFS		For Fucks Sake
FG		Freches/Fettes/Fieses Grinsen
FOAD	Fuck Off And Die[4]
FTFY	Fixed That For You[5]
FTR		For The Record
FTW		For The Win/Fuck the What
FU		Fuck you
FUBAR	Fucked Up Beyond All Repairs/Recognition
FUP, 	FUP2	Follow Up (to)
FWIW	For whatever its worth
FYEO/4YEO	For Your Eyes Only
FYI		For Your Information/Interest
FML		Fuck My Life
G		Grins
G2G/GTG	(Ive) Got To Go!/Gotta go!/(I) Got To Go
GF		Girlfriend
GG		großes Grinsen / Alternativ good Game im Sinne von gute Runde
GIDF/GIYF	Google ist dein Freund/Google is your friend
GJ		Good Job/Great Job
GL		Good Luck
GLG		Ganz liebe Grüße
GN(8)	Good Night/Gute Nacht
Graka/GraKa	Grafikkarte
Grats / Gratz / GZ	Congratulations
GTFO	Get The Fuck Out[6]
HAND	Have a nice day
HDF		Halt die Fresse / Halt deine Fresse
HDGDL	Hab dich ganz doll lieb
HDL		Hab dich lieb
HEL/HEAGDL	Hab euch lieb/Hab euch alle ganz doll lieb
HF		Have fun
HGW		Herzlichen Glückwunsch
HTH		Hope This Helps
IANAL	I am not a lawyer
IC		I See
IDA		Ich dich auch
IDK		I dont know”
IEA		Ich euch auch
IIRC oder auch WIMRE	If I Recall/Remember Correctly
IKR		I know, right?
ILD		Ich liebe dich
ILU/ILY	I Love U/You
IMHO	In My Humble Opinion
IMNSHO	In My Not So Humble Opinion
IMO		In My Opinion
IOW		In other words
IRL		In Real Life
ISTR	I Seem To Recall
JFYI	Just For Your Information
JFTR	Just for the record(s)
JK oder J/K	Just Kidding
JTLYK	Just to let you know...
k/kk/kay	OK/(Alles) klar
kA		Keine Ahnung
kB		Kein Bock
kP		Kein Plan oder Kein Problem
kD		Kein Ding
kT/kwT	kein (weiterer) Text
LD		Lieb Dich
LG		Liebe Grüße
LMAO	Laughing My Ass Off
LMFAO	Laughing My Fucking Ass Off
LMGTFY	Let Me Google That For You
LOFL	Lying on the floor Laughing[9]
LOL		Laughing Out Loud/Lots Of Laughing bzw. Lots Of Luck
mE		Meines Erachtens,Mit Einschränkung[en]/Erlaubnis
mk/mkay	hm okay
mMn		Meiner Meinung nach
mom		Moment
MOTD	Message Of The Day
N/A		Not Available/Applicable
n1		Nice one
n8		Night/Nacht
nc		no comment
nb/noob/n00b	Newbie
np	No Problem
NPOV	Neutral point of view 
NP:		Now Playing:
NSFL	Not safe for life
NSFW	Not safe/suitable for work
NSY		Not Seen Yet
NVM		Never mind
O RLY?	Oh really?
OLOY	Only Losers Obey YOLO
OMFG	Oh My Fucking God
OMG		Oh My God/Oh My Goodness
OP		Original Post/Original Poster/Over Powered
OT		Off Topic
oT/owT/OWT	Ohne (weiteren) Text
OTOH	On the other hand
PEBKAC / PBKC	Problem exists between keyboard and chair
PEBCAK	Problem exists between chair and keyboard
PICNIC	Akronym: Problem In Chair Not In Computer[12]
PLONK	Backronym: Please Leave Our Newsgroup, Kid
PLS/PLZ/PLX	Please
POV		Point of view
PPL		people
Q&A		Questions and answers
QFT		Quoted For Truth
QRY		Query
RE		Re (lat.)/ Ursprüngl. Ablativ von res (Sache), also in der Sache.... Später umgedeutet zu engl. Response/Reply
RE		Return(ed)
RL		Real Life
RLY?	Really?
ROFL/ROTFL	Rolling on (the) floor laughing
ROFLMAO/ROTFLMAO	Rolling on (the) floor laughing my ass off
RTFM	Read the fucking manual
SCNR	Sorry, Could Not Resist
SFW		Safe/suitable for work
SIG		Signatur/Signature
SMH		Shaking My Head
SNAFU	Situation Normal All Fucked Up
SO		Significant other
Sry		Sorry
STFU	Shut The Fuck Up
SuFu	Suchfunktion
TBH		to be honest
TGIF	Thank God Its Friday
THX/TNX/THNX/TX/TY	Thanks/Thank You
TIA		Thanks In Advance
TIL		Today I Learned
TL;DR/TLDR	Too Long; Didnt Read
TMI		Too Much Information
TOFU	Text oben Fullquote unten
TTYL/TTUL/T2UL	Talk To (2) You (u) Later
U		You …
UTFSE	Use The Fucking Search-Engine
V(L)G	viele (liebe) Grüße
vlt/vllt	Vielleicht
w00t	erstaunt-erfreutes Wie bitte?; erfreutes Juchhu!
w8		wait (engl.)
WB		Welcome back (engl.)
WD		Wieder da
WE		Weekend (engl.); Wochenende
WEG		Wide Evil Grin (engl.); breites böses Lächeln
WFM/wfm	Works for me (engl.)
WTF/wtf	What the fuck; seltener: Why the fuck (engl.)
WTH/wth	What the hell bzw. What the heck (engl.)
XOXO	Hugs and kisses!
Y?		Why?
YAW/YRW/YW	You are Welcome. / Youre Welcome
YHBT	You have been trolled.
YMMD	You made my day.
YMMV	Your mileage may vary
YOLO	You only live once.
Fomo	Father Mucker (Mutherfucker)
Mofo	Mutherfucker